10 10 10 10 10 10 10 10 10 10 10 10 10 10 10 10 10 10 10 10 30
10 10 10 10 10 10 10 10 10 10 10 10 10 10 10 10 10 10 10 10 30
10 10 10 10 10 10 10 10 10 10 10 10 10 10 10 10 10 10 10 10 30
10 10 10 10 10 10 10 10 10 10 10 10 10 10 10 10 10 10 10 10 30
10 10 10 10 10 10 10 10 10 10 10 10 10 10 10 10 10 10 10 10 30
10 10 10 10 10 10 10 10 10 10 10 10 10 10 10 10 10 10 10 10 30
10 10 10 10 10 10 10 10 10 10 10 10 10 10 10 10 10 10 10 10 30
10 10 10 10 10 10 10 10 10 10 10 10 10 10 10 10 10 10 10 10 30
10 10 10 10 10 10 10 10 10 10 10 10 10 10 10 10 10 10 10 10 30
10 10 10 10 10 10 10 10 10 10 10 10 10 10 10 10 10 10 10 10 30
10 10 10 10 10 10 10 10 10 10 10 10 10 10 10 10 10 10 10 10 30
25 25 25 25 25 25 25 25 25 25 25 25 25 25 25 25 25 25 25 25 25
26 26 26 26 26 26 26 26 26 26 26 26 26 26 26 26 26 26 26 26 26
26 26 26 26 26 26 26 26 26 26 26 26 26 26 26 26 26 26 26 26 26
26 26 26 26 26 26 26 26 26 26 26 26 26 26 26 26 26 26 26 26 26
