3 6 6 6 6 6 6 6 6 6 6 6 6 6 6 6 6 6 6 2
1 7 0 0 0 0 0 0 0 0 0 0 0 0 0 0 0 0 7 1
1 0 0 0 0 0 0 0 0 0 0 0 0 0 0 0 0 0 0 1 
1 0 3 6 6 0 0 3 6 6 0 0 3 6 6 0 0 0 0 1
1 0 1 0 0 0 0 1 0 0 0 0 1 0 0 0 0 0 0 1
1 0 1 6 6 0 0 1 0 0 0 0 4 6 2 0 0 0 0 1
1 0 1 0 0 0 0 1 0 0 0 0 0 0 1 0 0 0 0 1
1 0 1 0 0 0 0 4 6 6 0 0 6 6 5 0 0 0 0 1
1 0 0 0 0 0 0 0 0 0 0 0 0 0 0 0 0 0 0 1
1 0 0 0 0 0 0 0 0 0 0 0 0 0 0 0 0 0 0 1
1 0 0 0 0 0 0 0 0 0 0 0 0 0 0 0 0 0 0 1
1 0 0 0 0 0 0 0 0 0 0 0 0 0 0 0 0 0 0 1
1 0 0 0 0 0 0 0 0 0 0 0 0 0 0 0 0 0 0 1
1 7 0 0 0 0 0 0 0 0 0 0 0 0 0 0 0 0 7 1
4 6 6 6 6 6 6 6 6 6 6 6 6 6 6 6 6 6 6 5