21 21 21 21 21 21 21 21 21 21 21 21 21 21 21 21 21 21 21 21 21 21 21 21 21 21 21 21 21 21 21 21 21 21 21 21 21 21 21 21 21 21 21 21 21 21 21 21 21 21
21 21 21 21 21 21 21 21 21 21 21 21 21 21 21 21 21 21 21 21 21 21 21 21 21 21 21 21 21 21 21 21 21 21 21 21 21 21 21 21 21 21 21 21 21 21 21 21 21 21
21 21 21 21 21 21 21 21 21 21 21 21 21 21 21 21 21 21 21 21 21 21 21 21 21 21 21 21 21 21 21 21 21 21 21 21 21 21 21 21 21 21 21 21 21 21 21 21 21 21
21 21 21 21 21 21 21 21 21 21 21 21 21 21 21 21 21 21 21 21 21 21 21 21 21 21 21 21 21 21 21 21 21 21 21 21 21 21 21 21 21 21 21 21 21 21 21 21 21 21
21 21 21 21 21 21 21 21 21 21 21 21 21 21 21 21 21 21 21 21 21 21 21 21 21 21 21 21 21 21 21 21 21 21 21 21 21 21 21 21 21 21 21 21 21 21 21 21 21 21
21 21 21 21 21 21 21 21 21 21 21 21 21 21 21 21 21 21 21 21 21 21 21 21 21 21 21 21 21 21 21 21 21 21 21 21 21 21 21 21 21 21 21 21 21 21 21 21 21 21
21 21 21 21 21 21 21 21 21 21 21 21 21 21 21 21 21 21 21 21 21 21 21 21 21 21 21 21 21 21 21 21 21 21 21 21 21 21 21 21 21 21 21 21 21 21 21 21 21 21
21 21 21 21 21 21 21 21 21 21 20 20 20 20 20 20 20 20 20 20 20 20 20 20 20 20 20 20 20 20 20 20 20 20 20 20 20 20 20 20 21 21 21 21 21 21 21 21 21 21
21 21 21 21 21 21 21 21 21 22 13 16 16 16 16 16 16 16 16 16 16 16 16 16 16 18 16 16 16 16 16 16 16 16 16 16 16 16 16 12 23 21 21 21 21 21 21 21 21 21
21 21 21 21 21 21 21 21 21 22 10 10 10 10 10 10 10 10 10 10 10 10 10 10 10 11 10 10 10 10 10 10 10 10 10 10 10 10 10 10 23 21 21 21 21 21 21 21 21 21
21 21 21 21 21 21 21 21 21 22 10 10 10 10 10 10 10 10 10 10 10 10 10 10 10 11 10 10 10 10 10 10 10 10 10 10 10 10 10 10 23 21 21 21 21 21 21 21 21 21
21 21 21 21 21 21 21 21 21 22 10 10 10 10 10 10 10 10 10 10 10 10 10 10 10 11 10 10 10 10 10 10 10 10 10 10 10 10 10 10 23 21 21 21 21 21 21 21 21 21
21 21 21 21 21 21 21 21 21 22 10 10 10 10 10 10 10 10 10 10 10 10 10 10 10 11 10 10 10 10 10 10 10 10 10 10 10 10 10 10 23 21 21 21 21 21 21 21 21 21
21 21 21 21 21 21 21 21 21 22 10 10 10 10 10 10 10 10 10 10 10 10 10 10 10 11 10 10 10 10 10 10 10 10 10 10 10 10 10 10 23 21 21 21 21 21 21 21 21 21
21 21 21 21 21 21 21 21 21 22 10 10 10 10 10 10 10 10 10 10 10 10 10 10 10 11 10 10 10 10 10 10 10 10 10 10 10 10 10 10 23 21 21 21 21 21 21 21 21 21
21 21 21 21 21 21 21 21 21 22 10 10 10 10 10 10 10 10 10 10 10 10 10 10 10 11 10 10 10 10 10 10 10 10 10 10 10 10 10 10 23 21 21 21 21 21 21 21 21 21
21 21 21 21 21 21 21 21 21 22 10 10 10 10 10 10 10 10 10 10 10 30 30 30 30 11 10 10 10 10 10 10 10 10 10 10 10 10 10 10 23 21 21 21 21 21 21 21 21 21
21 21 21 21 21 21 21 21 21 22 10 10 10 10 10 10 10 10 10 10 10 30 31 31 30 11 10 10 10 10 10 10 10 10 10 10 10 10 10 10 23 21 21 21 21 21 21 21 21 21
21 21 21 21 21 21 21 21 21 22 10 10 10 10 10 10 10 10 10 10 10 30 31 31 30 11 10 10 10 10 10 10 10 10 10 10 10 10 10 10 23 21 21 21 21 21 21 21 21 21
21 21 21 21 21 21 21 21 21 22 10 10 10 10 10 10 10 10 10 10 10 30 31 31 30 11 10 10 10 10 10 10 10 10 10 10 10 10 10 10 23 21 21 21 21 21 21 21 21 21
21 21 21 21 21 21 21 21 21 22 10 10 10 10 10 10 10 10 10 10 10 30 30 31 30 11 10 10 10 10 10 10 10 10 10 10 10 10 10 10 23 21 21 21 21 21 21 21 21 21
21 21 21 21 21 21 21 21 21 22 10 10 10 10 10 10 10 10 10 10 10 10 10 11 10 11 10 10 10 10 10 10 10 10 10 10 10 10 10 10 23 21 21 21 21 21 21 21 21 21
21 21 21 21 21 21 21 21 21 22 10 10 10 10 10 10 10 10 10 10 10 10 10 11 10 11 10 10 10 10 10 10 10 10 10 10 10 10 10 10 23 21 21 21 21 21 21 21 21 21
21 21 21 21 21 21 21 21 21 22 10 10 10 10 10 10 10 10 10 10 10 10 10 11 10 11 10 10 10 10 10 10 10 10 10 10 10 10 10 10 23 21 21 21 21 21 21 21 21 21
21 21 21 21 21 21 21 21 21 22 10 10 10 10 10 10 10 10 10 10 10 10 10 10 19 19 19 10 10 10 10 10 10 10 10 10 10 10 10 10 23 21 21 21 21 21 21 21 21 21
21 21 21 21 21 21 21 21 21 22 10 10 10 10 10 10 10 10 10 10 10 10 10 10 19 19 19 10 10 10 10 10 10 10 10 10 10 10 10 10 23 21 21 21 21 21 21 21 21 21
21 21 21 21 21 21 21 21 21 22 10 10 10 10 10 10 10 10 10 10 10 10 10 10 19 19 19 10 10 10 10 10 10 10 10 10 10 10 10 10 23 21 21 21 21 21 21 21 21 21
21 21 21 21 21 21 21 21 21 22 10 10 10 10 10 10 10 10 10 10 10 10 10 10 10 10 10 10 10 10 10 10 10 10 10 10 10 10 10 10 23 21 21 21 21 21 21 21 21 21
21 21 21 21 21 21 21 21 21 22 10 10 10 10 10 10 10 10 10 10 10 10 10 10 10 10 10 10 10 10 10 10 10 10 10 10 10 10 10 10 23 21 21 21 21 21 21 21 21 21
21 21 21 21 21 21 21 21 21 22 10 10 10 10 10 10 10 10 10 10 10 10 10 10 10 10 10 10 10 10 10 10 10 10 10 10 10 10 10 10 23 21 21 21 21 21 21 21 21 21
21 21 21 21 21 21 21 21 21 22 10 10 10 10 10 10 10 10 10 10 10 10 10 10 10 10 10 10 10 10 10 10 10 10 10 10 10 10 10 10 23 21 21 21 21 21 21 21 21 21
21 21 21 21 21 21 21 21 21 22 10 10 10 10 10 10 10 10 10 10 10 10 10 10 10 10 10 10 10 10 10 10 10 10 10 10 10 10 10 10 23 21 21 21 21 21 21 21 21 21
21 21 21 21 21 21 21 21 21 22 10 10 10 10 10 10 10 10 10 10 10 10 10 10 10 10 10 10 10 10 10 10 10 10 10 10 10 10 10 10 23 21 21 21 21 21 21 21 21 21
21 21 21 21 21 21 21 21 21 22 10 10 10 10 10 10 10 10 10 10 10 10 10 10 10 10 10 10 10 10 10 10 10 10 10 10 10 10 10 10 23 21 21 21 21 21 21 21 21 21
21 21 21 21 21 21 21 21 21 22 10 10 10 10 10 10 10 10 10 10 10 10 10 10 10 10 10 10 10 10 10 10 10 10 10 10 10 10 10 10 23 21 21 21 21 21 21 21 21 21
21 21 21 21 21 21 21 21 21 22 10 10 10 10 10 10 10 10 10 10 10 10 10 10 10 10 10 10 10 10 10 10 10 10 10 10 10 10 10 10 23 21 21 21 21 21 21 21 21 21
21 21 21 21 21 21 21 21 21 22 10 10 10 10 10 10 10 10 10 10 10 10 10 10 10 10 10 10 10 10 10 10 10 10 10 10 10 10 10 10 23 21 21 21 21 21 21 21 21 21
21 21 21 21 21 21 21 21 21 22 10 10 10 10 10 10 10 10 10 10 10 10 10 10 10 10 10 10 10 10 10 10 10 10 10 10 10 10 10 10 23 21 21 21 21 21 21 21 21 21
21 21 21 21 21 21 21 21 21 22 10 10 10 10 10 10 10 10 10 10 10 10 10 10 10 10 10 10 10 10 10 10 10 10 10 10 10 10 10 10 23 21 21 21 21 21 21 21 21 21
21 21 21 21 21 21 21 21 21 22 10 10 10 10 10 10 10 10 10 10 10 10 10 10 10 10 10 10 10 10 10 10 10 10 10 10 10 10 10 10 23 21 21 21 21 21 21 21 21 21
21 21 21 21 21 21 21 21 21 22 10 10 10 10 10 10 10 10 10 10 10 10 10 10 10 10 10 10 10 10 10 10 10 10 10 10 10 10 10 10 23 21 21 21 21 21 21 21 21 21
21 21 21 21 21 21 21 21 21 22 10 10 10 10 10 10 10 10 10 10 10 10 10 10 10 10 10 10 10 10 10 10 10 10 10 10 10 10 10 10 23 21 21 21 21 21 21 21 21 21
21 21 21 21 21 21 21 21 21 21 21 21 21 21 21 21 21 21 21 21 21 21 21 21 21 21 21 21 21 21 21 21 21 21 21 21 21 21 21 21 21 21 21 21 21 21 21 21 21 21
21 21 21 21 21 21 21 21 21 21 21 21 21 21 21 21 21 21 21 21 21 21 21 21 21 21 21 21 21 21 21 21 21 21 21 21 21 21 21 21 21 21 21 21 21 21 21 21 21 21
21 21 21 21 21 21 21 21 21 21 21 21 21 21 21 21 21 21 21 21 21 21 21 21 21 21 21 21 21 21 21 21 21 21 21 21 21 21 21 21 21 21 21 21 21 21 21 21 21 21
21 21 21 21 21 21 21 21 21 21 21 21 21 21 21 21 21 21 21 21 21 21 21 21 21 21 21 21 21 21 21 21 21 21 21 21 21 21 21 21 21 21 21 21 21 21 21 21 21 21
21 21 21 21 21 21 21 21 21 21 21 21 21 21 21 21 21 21 21 21 21 21 21 21 21 21 21 21 21 21 21 21 21 21 21 21 21 21 21 21 21 21 21 21 21 21 21 21 21 21
21 21 21 21 21 21 21 21 21 21 21 21 21 21 21 21 21 21 21 21 21 21 21 21 21 21 21 21 21 21 21 21 21 21 21 21 21 21 21 21 21 21 21 21 21 21 21 21 21 21
21 21 21 21 21 21 21 21 21 21 21 21 21 21 21 21 21 21 21 21 21 21 21 21 21 21 21 21 21 21 21 21 21 21 21 21 21 21 21 21 21 21 21 21 21 21 21 21 21 21
21 21 21 21 21 21 21 21 21 21 21 21 21 21 21 21 21 21 21 21 21 21 21 21 21 21 21 21 21 21 21 21 21 21 21 21 21 21 21 21 21 21 21 21 21 21 21 21 21 21
